###########
#>>>......#
####.######
#.<<<#   >E
#....#  >^#
#.######^##
#>>>>>>>^.#
###########
